1111111e11111111111111e111111111
10000000000000000000000000000001
1000000000000000000000k000000001
10000000000000000001111111100001
e0000000000k0000000000000000000e
10000000001111111110000000000001
10000000000000000000000000000001
11111111110000000001111111111111
100000000k0000000000000000k00001
10001111111111111100000001110001
10001000000000000000000000000001
10001000000000000000111111111111
11111111100000000k00000000000001
10000000000001111111110000000001
e000000000000000000000000k00000e
100p0000000000000000111111111111
1000000000000k000000000000000001
111111e11111111111111111e1111111