11111111111111111111111111111111
10000000000000000000000000000001
100000d000000000000000k000000001
10000000000000000001111111100001
10000000000000000000000000000001
10001111111110000000000000000001
10000000000000000000000000000001
10000000000011111111111000000001
11111110000000000000000000000001
10000010000000000000001111110001
10001111111100000k00000000000001
10000000000000111111111000000001
10000000000000100000001000000001
11111100000111100000001111111111
10000100p00100000000000000000001
11111111111111111111111111111111
10000000000000000000000000000001
11111111111111111111111111111111