111111e1111111111111111111111111
10000000000000000000000000000001
10000000000000000000000000000001
10000000000000001111110000111111
10000000000000000000000000000001
10000000000000000000011111100001
10000000k0000000000000000000k001
10001111111110001111111111111111
1000000000000000k000000000000001
10000000111111111111111100000001
100k0000000000000000000000000001
11111111111111111110000001111111
10000000000000000000000000000k01
10000000000000000000011111111111
10000000000000000000010000000001
100p0000011111111111110000000001
10000000000000000000000000000001
11111111111111111111111111111111