11111111111111111111111111111111
10000000000000000000000000000001
10000000000000000000000000k00001
10000000000000000000000111111111
10000000111111100000000000000001
e000000000000011111111000000000e
10000000000000000000010000000001
100000000k0000000000111111110001
10011111110000000000000000000001
10000000000000000111111110000001
10000001111111100000000000000k01
10000000000000000000000011111111
10001110000000000000000000000001
10000k10000000000000111111000001
1111111111110000000000k100000001
100p0000000000000111111111111001
10000000000111111100000k00000001
11111111111111111111111111111111