11111111111111111111111111111111
10000000000000000000000000000001
e0000000000000000000000000000001
10000000k0000000000000000000000e
10001111111111000000000000000001
10000000000000000000111111111111
10000000000000000000000000000001
11111111111111100000000000000001
10000000000000000001111111111111
100k0000000000000000001k00000001
11111111111000000111111111100001
100000000000k0000000000000000001
e0000000111111111100000111111111
10001111100000000000000000000001
10000p00000000000001111111100001
111111111110000000000000001k0001
100000000000000000010000k0111111
11111111111111111111111111111111