11111111111111111111111111111111
10000000000000000000000000000001
10000000000000000000000000000001
10000000000000000000000000000001
10000000000000000000000000000001
10000000000000000000111111100001
10000000000000000000000000000001
10000000000000000000000000000001
10000001111100000000000000000001
10000000000000000000000000000001
10000000000000000000000000000001
10000000000000000000000000000001
10000000000000000000000000000001
10000000000011111000000000000001
10000000000000000000000000000001
1000p000000000000000000000000001
10000000000000000000000000000001
11111111111111111111111111111111