11111111111111111111111111111111
10000000000000000000000000000001
10000000000000000000000000000001
10000000000000000000000000000001
10000000000000000000000000000001
10000000000000000000000000000001
10000000000000000000000000000001
10000000000000000000000000000001
10000000000000000000000000000001
10000000000000000000000000000001
10000000000000000000000000000001
10000000000011111110000000000001
10000000000000000000000000000001
10000000000000000000011111111111
10000000000000000000000000000001
100p0000011111111111000000000001
10000000000000000000000000000001
11111111111111111111111111111111